m	ん
n	ん
k	っ
g	っ
s	っ
z	っ
j	っ
t	っ
c	っ
d	っ
h	っ
b	っ
p	っ
f	っ
y	っ
r	っ
w	っ
v	っ
xa	ぁ
a	あ
xi	ぃ
i	い
xu	ぅ
u	う
whu	う
wha	うぁ
whi	うぃ
whe	うぇ
who	うぉ
xe	ぇ
e	え
xo	ぉ
o	お
ka	か
ga	が
ki	き
kyi	きぃ
kye	きぇ
kya	きゃ
kyu	きゅ
kyo	きょ
gi	ぎ
gyi	ぎぃ
gye	ぎぇ
gya	ぎゃ
gyu	ぎゅ
gyo	ぎょ
ku	く
gu	ぐ
ke	け
ge	げ
ko	こ
go	ご
sa	さ
za	ざ
shi	し
si	し
syi	しぃ
she	しぇ
sye	しぇ
sha	しゃ
sya	しゃ
shu	しゅ
syu	しゅ
sho	しょ
syo	しょ
ji	じ
zi	じ
zyi	じぃ
je	じぇ
zye	じぇ
ja	じゃ
zya	じゃ
ju	じゅ
zyu	じゅ
jo	じょ
zyo	じょ
su	す
zu	ず
se	せ
ze	ぜ
so	そ
zo	ぞ
ta	た
da	だ
chi	ち
ti	ち
tyi	ちぃ
che	ちぇ
tye	ちぇ
cha	ちゃ
tya	ちゃ
chu	ちゅ
tyu	ちゅ
cho	ちょ
tyo	ちょ
di	ぢ
dyi	ぢぃ
dye	ぢぇ
dya	ぢゃ
dyu	ぢゅ
dyo	ぢょ
q	っ
xtu	っ
tu	つ
tsa	つぁ
tsi	つぃ
tsu	つ
tse	つぇ
tso	つぉ
du	づ
dza	づぁ
dzi	づぃ
dzu	づ
dze	づぇ
dzo	づぉ
te	て
thi	てぃ
the	てぇ
tha	てゃ
thu	てゅ
tho	てょ
de	で
dhi	でぃ
dhe	でぇ
dha	でゃ
dhu	でゅ
dho	でょ
to	と
twa	とぁ
twi	とぃ
twu	とぅ
twe	とぇ
two	とぉ
do	ど
dwa	どぁ
dwi	どぃ
dwu	どぅ
dwe	どぇ
dwo	どぉ
na	な
ni	に
nyi	にぃ
nye	にぇ
nya	にゃ
nyu	にゅ
nyo	にょ
nu	ぬ
ne	ね
no	の
ha	は
ba	ば
pa	ぱ
hi	ひ
hyi	ひぃ
hye	ひぇ
hya	ひゃ
hyu	ひゅ
hyo	ひょ
bi	び
byi	びぃ
bye	びぇ
bya	びゃ
byu	びゅ
byo	びょ
pi	ぴ
pyi	ぴぃ
pye	ぴぇ
pya	ぴゃ
pyu	ぴゅ
pyo	ぴょ
fu	ふ
hu	ふ
fa	ふぁ
fi	ふぃ
fe	ふぇ
fo	ふぉ
bu	ぶ
pu	ぷ
he	へ
be	べ
pe	ぺ
ho	ほ
bo	ぼ
po	ぽ
ma	ま
mi	み
myi	みぃ
mye	みぇ
mya	みゃ
myu	みゅ
myo	みょ
mu	む
me	め
mo	も
xya	ゃ
ya	や
xyu	ゅ
yu	ゆ
xyo	ょ
yo	よ
ra	ら
ri	り
ryi	りぃ
rye	りぇ
rya	りゃ
ryu	りゅ
ryo	りょ
ru	る
re	れ
ro	ろ
xwa	ゎ
wa	わ
wi	ゐ
we	ゑ
wo	を
l	ん
xn	ん
v	ゔ
vu	ゔ
va	ゔぁ
vi	ゔぃ
ve	ゔぇ
vo	ゔぉ
xka	ゕ
xke	ゖ
zd	ゝ
zd	ゞ
zd	々
zb	゛
zp	゜
,	、
-	ー
.	。
/	／
[	「
\	￥
]	」
z1	○
z!	●
z2	▽
z@	▼
z3	△
z#	▲
z4	□
z$	■
z5	◇
z%	◆
z6	☆
z^	★
z7	◎
z&	£
z8	¢
z*	×
z9	♂
z(	【
z0	♀
z)	】
z-	〜
z_	∴
z=	≠
z+	±
z\	＼
z|	‖
z`	´
z~	¨
zq	《
zQ	〈
zw	》
zW	〉
zr	々
zR	仝
zt	〆
zT	§
zp	〒
zP	↑
z[	『
z{	〔
z]	』
z}	〕
zs	ヽ
zS	ヾ
zd	ゝ
zD	ゞ
zf	〃
zF	→
zg	‐
zG	—
zh	←
zj	↓
zk	↑
zl	→
z;	゛
z:	゜
z'	‘
z"	“
zx	:-
zX	:-)
zc	〇
zC	℃
zv	※
zV	÷
zb	°
zB	←
zn	′
zN	↓
zm	″
zM	〓
z,	‥
z<	≦
z.	…
z>	≧
z/	・
z?	∞
