m	ン
n	ン
k	ッ
g	ッ
s	ッ
z	ッ
j	ッ
t	ッ
c	ッ
d	ッ
h	ッ
b	ッ
p	ッ
f	ッ
y	ッ
r	ッ
w	ッ
v	ッ
xa	ァ
a	ア
xi	ィ
i	イ
xu	ゥ
u	ウ
whu	ウ
wha	ウァ
whi	ウィ
whe	ウェ
who	ウォ
xe	ェ
e	エ
xo	ォ
o	オ
ka	カ
ga	ガ
ki	キ
kyi	キィ
kye	キェ
kya	キャ
kyu	キュ
kyo	キョ
gi	ギ
gyi	ギィ
gye	ギェ
gya	ギャ
gyu	ギュ
gyo	ギョ
ku	ク
gu	グ
ke	ケ
ge	ゲ
ko	コ
go	ゴ
sa	サ
za	ザ
shi	シ
si	シ
syi	シィ
she	シェ
sye	シェ
sha	シャ
sya	シャ
shu	シュ
syu	シュ
sho	ショ
syo	ショ
ji	ジ
zi	ジ
zyi	ジィ
je	ジェ
zye	ジェ
ja	ジャ
zya	ジャ
ju	ジュ
zyu	ジュ
jo	ジョ
zyo	ジョ
su	ス
zu	ズ
se	セ
ze	ゼ
so	ソ
zo	ゾ
ta	タ
da	ダ
chi	チ
ti	チ
tyi	チィ
che	チェ
tye	チェ
cha	チャ
tya	チャ
chu	チュ
tyu	チュ
cho	チョ
tyo	チョ
di	ヂ
dyi	ヂィ
dye	ヂェ
dya	ヂャ
dyu	ヂュ
dyo	ヂョ
q	ッ
xtu	ッ
tu	ツ
tsa	ツァ
tsi	ツィ
tsu	ツ
tse	ツェ
tso	ツォ
du	ヅ
dza	ヅァ
dzi	ヅィ
dzu	ヅ
dze	ヅェ
dzo	ヅォ
te	テ
thi	ティ
the	テェ
tha	テャ
thu	テュ
tho	テョ
de	デ
dhi	ディ
dhe	デェ
dha	デャ
dhu	デュ
dho	デョ
to	ト
twa	トァ
twi	トィ
twu	トゥ
twe	トェ
two	トォ
do	ド
dwa	ドァ
dwi	ドィ
dwu	ドゥ
dwe	ドェ
dwo	ドォ
na	ナ
ni	ニ
nyi	ニィ
nye	ニェ
nya	ニャ
nyu	ニュ
nyo	ニョ
nu	ヌ
ne	ネ
no	ノ
ha	ハ
ba	バ
pa	パ
hi	ヒ
hyi	ヒィ
hye	ヒェ
hya	ヒャ
hyu	ヒュ
hyo	ヒョ
bi	ビ
byi	ビィ
bye	ビェ
bya	ビャ
byu	ビュ
byo	ビョ
pi	ピ
pyi	ピィ
pye	ピェ
pya	ピャ
pyu	ピュ
pyo	ピョ
fu	フ
hu	フ
fa	ファ
fi	フィ
fe	フェ
fo	フォ
bu	ブ
pu	プ
he	ヘ
be	ベ
pe	ペ
ho	ホ
bo	ボ
po	ポ
ma	マ
mi	ミ
myi	ミィ
mye	ミェ
mya	ミャ
myu	ミュ
myo	ミョ
mu	ム
me	メ
mo	モ
xya	ャ
ya	ヤ
xyu	ュ
yu	ユ
xyo	ョ
yo	ヨ
ra	ラ
ri	リ
ryi	リィ
rye	リェ
rya	リャ
ryu	リュ
ryo	リョ
ru	ル
re	レ
ro	ロ
xwa	ヮ
wa	ワ
wi	ヰ
we	ヱ
wo	ヲ
l	ン
xn	ン
v	ヴ
vu	ヴ
va	ヴァ
vi	ヴィ
ve	ヴェ
vo	ヴォ
xka	ヵ
xke	ヶ
zd	ヽ
zd	ヾ
zd	々
zb	゛
zp	゜
,	、
-	ー
.	。
/	／
[	「
\	￥
]	」
z1	○
z!	●
z2	▽
z@	▼
z3	△
z#	▲
z4	□
z$	■
z5	◇
z%	◆
z6	☆
z^	★
z7	◎
z&	£
z8	¢
z*	×
z9	♂
z(	【
z0	♀
z)	】
z-	〜
z_	∴
z=	≠
z+	±
z\	＼
z|	‖
z`	´
z~	¨
zq	《
zQ	〈
zw	》
zW	〉
zr	々
zR	仝
zt	〆
zT	§
zp	〒
zP	↑
z[	『
z{	〔
z]	』
z}	〕
zs	ヽ
zS	ヾ
zd	ヽ
zD	ヾ
zf	〃
zF	→
zg	‐
zG	—
zh	←
zj	↓
zk	↑
zl	→
z;	゛
z:	゜
z'	‘
z"	“
zx	:-
zX	:-)
zc	〇
zC	℃
zv	※
zV	÷
zb	°
zB	←
zn	′
zN	↓
zm	″
zM	〓
z,	‥
z<	≦
z.	…
z>	≧
z/	・
z?	∞
